1111111111
100P00C001
11111E1111
1111111111
1000000001
1001111111
1001000001
1001111101
1000100001
1111111111